11111111111111111111111111111
11111111D000000001100000011111
11111111101100000111E0000D111
11111111100100000000000D01111
11111111101100000111000000N01
10000000001100000111011111111
11110111111111011100000010001
1111D111111111011101010010001
11000000110101011D00000010001
1000000000000000DD000000D0001
10000000000000001101010010001
11000001110101011111011110001
11110111111101011101111010001
11111111111111111111111111111