1111111111111111111111111111111111111111111
1111111110000000001100000000000011111101111
1111111110110000011100000000000000000000001
1111111110010000000000000000000011111111111
111111111011000001110000000000001
100000000011000001110111111111111
11110111111111011100000010001
11110111111111011101010010001
11000000110101011100000010001
1000000000000N001100000010001
10000000000000001101010010001
1100000111010101111101111000111
11110111111101011101111010001
11111111111111111111111111111