1111111111111111111111
10000000000000000000W1
1111111110000000000001
1000000011100000000001
1000000000110000000001
1000000000000000000001
1000000000000000000001
1000000000000000000001
1000000000000000000001
1000000000000100000001
1000000000000000000001
1111111111111111111111