11111111111111111111111111111
11111111D00000000110000001Z011
11111111101100000111E0000D001
11111111100100000000000D01111
1111111110110Z000111000000N01
10000000001100000111011111111
11110111111111011100000010001
1111D111111111011101010010001
11000000110101011D000Z0010001
1000000000000000DD000000D0001
10000000000000001101010010001
11000001110101011111011110001
11110111111101011101111010001
11111111111111111111111111111