1111111111111111111111
1000000000000000000001
1111111110000000000001
1000000001100000000001
1000000000110000000001
1000000000000000000001
1111111111111111111111