11111111111111111111111111111
11111111D000000001100000010011
1111111110110000011100000D001
11111111100100000000000D01111
1111111110110Z000111000000001
10000000001100000111011111111
11110111111111011100000010001
1111D111111111011101010010001
110000000000000001D00Z0010001
100000000Z00Z00000000000D0001
10000E0000000Z0001101010010011
11000001110101011111011110001
11110111111101011101111010001
11111111111111111111111111111