11111111111111111111111111111
11111111100000000011000000001
11111111101100000111000000001
11111111100100000000000000001
11111111101100000111000000001
10000000001100000111011111111
11110111111111011100000010001
1111D111111111011101010010001
11000000110101011100000010001
1000000000000N001100000010001
10000000000000001101010010001
11000001110101011111011110001
11110111111101011101111010001
11111111111111111111111111111