1111111111111111111111
100000000000000000S001
1111111110000000000001
1000000011100000000001
1000000000110000000001
1000000000000000000001
1000000000000000000001
1000001100000000000001
1000000000000000000001
1000000000000100000001
1000000000000000000001
1000000000000000000001
1000000000000000001001
1000000000000010000001
1000000000000000000001
1000000000000000000001
1000000000000000000001
1000000000000000000001
1000000000000000000001
1111111111111111111111