NO ./textures/wall_1.xpm
SO ./textures/wall_3.xpm
EA ./textures/wall_2.xpm
WE ./textures/wall_4.xpm
DO ./textures/door.xpm

ZI ./textures/zombie_move_2.xpm
ZM ./textures/zombie_move_1.xpm
ZH ./textures/zombie_hit.xpm
BI ./textures/boss.xpm
BM ./textures/boss_2.xpm

LI ./textures/laser_idle.xpm
LM ./textures/laser_move.xpm
LS ./textures/laser_shot.xpm
GI ./textures/gun_idle.xpm
GM ./textures/gun_move.xpm
GS ./textures/gun_shot.xpm

F          33,33,33
C      33,33,33

11111111111111111111111111111111111111111111111111111111111111
10000000000000000000000000000000000000000000000100000011111111
10000000000000000000000000000000000000000000000100000010111111
10000000000000000000000000000000000Z00000000000100000010111111
10000000000000000000000001100000000000000000000100000000011111
1000000000000000000000000000E000000000000000000D00000000011111
10000000000000000000000000000000000111111111111111111111111111
10000000000000000000000000000000000000000000000000000000000001
10000000000000000000000000000000000000000000000000000010000001
11111111111111111111111111100000000000000000000000000100000001
10000000000000000000000000000000000100000000000000000010000001
10000000000000000000000000000000001010000000000000000000000001
10000000000000000000000000000000000100000000001000000000000001
10000000000000000000000000000000000000000000000000000000000001
10000000000000000000000000000000000000000000000000001000000001
11111111111111111111111111111111111111111111111111111111111111