11111111111111111111111111111111111111111111111111111111111111
100000000000000000000000000000000000B0000000000000000000000001
10000000000000000000000000000000000000000000000000000000000001
10000000000000000000000000000000000000000000000000000000000001
10000000000000000000000001100000000000000000000000000000000001
10000000000000000000000000000000000000000000000000000000000001
10000000000000000000000000000000000111111111111111111111111111
10000000000000000000000000000000000000000000000000000000000001
100000000000000000000000000000000000000000000000000000Z0000001
11111111111111111111111111100000000000000000000000000Z00000001
100000000000000000000000000000000001000000000000000000Z0000001
100000000000000000000E0000000000001Z10000000000000000000000001
1000000000000000000000000000000000010000000000Z000000000000001
10000000000000000000000000000000000000000000000000000000000001
1000000000000000000000000000000000000000000000000000Z000000001
11111111111111111111111111111111111111111111111111111111111111