11111111111111111111111111111111111111111111111111111111111111
100000000000000000000000000000000000B0000000000100000011111111
10000000000000000000000000000000000000000000000100000010111111
10000000000000000000000000000000000Z00000000000100000010111111
100000000000000000000000011000000000000000000001000000Z0011111
1000000000000000000000000000E000000000000000000D00000000011111
10000000000000000000000000000000000111111111111111111111111111
10000000000000000000000000000000000000000000000000000000000001
10000000000000000000000000000000000000000000000000000010000001
11111111111111111111111111100000000000000000000000000100000001
10000000000000000000000000000000000100000000000000000010000001
10000000000000000000000000000000001Z10000000000000000000000001
10000000000000000000000000000000000100000000001000000000000001
10000000000000000000000000000000000000000000000000000000000001
10000000000000000000000000000000000000000000000000001000000001
11111111111111111111111111111111111111111111111111111111111111