NO ./textures/wall_1.xpm
SO ./textures/wall_3.xpm
EA ./textures/wall_2.xpm
WE ./textures/wall_4.xpm
DO ./textures/door.xpm

ZI ./textures/zombie_move_2.xpm
ZM ./textures/zombie_move_1.xpm
ZH ./textures/zombie_hit.xpm
BI ./textures/boss.xpm
BM ./textures/boss_2.xpm

LI ./textures/laser_idle.xpm
LM ./textures/laser_move.xpm
LS ./textures/laser_shot.xpm
GI ./textures/gun_idle.xpm
GM ./textures/gun_move.xpm
GS ./textures/gun_shot.xpm

F          33,33,33
C      33,33,33






 1
101
 1
0111111111111111111111111
1000000000000000000000001
110000000000000E000000001
10000000000000000000000011111111
111111111000000000000000000000001
100000000000000000000000000001111
10000000000000010000000000000
10000000000000000000000000001
10000000000000000000000000001
10000000000000000000000000001
10000000000000000001010000001
11000001110101011111011110101
11110111 1110111 101111010001
11111111 1111111 111111111111